NO ./path_to_the_north_texture
SO ./path_to_the_south_texture
WE ./path_to_the_west_texture
EA ./path_to_the_east_texture
C 255,100, 99
F 5,200, 50


111111111111111
100001000000000001
100000000000010001
100N0001000000001
100000000000000001
111111111111111