NO ./path_to_the_north_texture
SO ./path_to_the_south_texture
WE ./path_to_the_west_texture
EA ./path_to_the_east_texture
C 2,2, 2
F 2,2,2


1111111      
1000001
1N00001
11111111
11111111