NO ./texture/wall.xpm
SO ./texture/wall2.xpm
WE ./texture/wall3.xpm
EA ./texture/wall4.xpm
F 5,200, 50
C 25,100, 99

        1111111111111111111111111
        1000000000000000000000001
        1000000000000000000000001
111111111000000000N00000011111111
1000000000000000000000001
1000000000100000000000001
1111111111 111111111111111    
