NO ./path_to_the_north_texture
WE ./path_to_the_west_texture
EA ./path_to_the_east_texture
SO ./path_to_the_south_texture


111111111111111111111111111111111111
1N0111111111111111111111111111111111
111111111111111111111111111111011111
111111111111111111111111111111111111
110011110000011111111111111111111111
1111
F 220,1,123
C 225,30,0