NO ./path_to_the_north_texture
SO ./path_to_the_south_texture
WE ./path_to_the_west_texture
EA ./path_to_the_east_texture
C 25,100, 99
F 5,200, 50


1111111      
1000001
1N00001
1000001
1100001
1111111